1111111
1000000
1000001
1000001
1 11111