1111111
10000C1
1000001
100E011
1111111