11111111111111111111
10100000000000001001
10001C00010000000001
1000E0000P0000000001
10100100111111100001
10100000000000000001
11111111111111111111